19 12
12 12 12 12 12 12 12 12 12 12 12 12 12 12 12 12 12 12 12 
11 11 11 11 11 11 11 11 11 11 11 11 11 11 11 11 11 11 11  
8 10 8 10 8 8 10 10 10 8 8 10 10 8 8 10 8 10 10
10 8 10 10 8 10 10 8 10 8 8 10 8 10 8 8 10 8 10
8 8 10 8 8 10 8 10 8 8 10 8 8 10 10 8 8 10 8
8 10 8 8 10 8 8 8 8 10 8 8 8 10 8 8 10 8 8
8 8 10 8 10 8 8 10 10 8 10 8 10 8 8 10 8 10 8 
8 8 10 8 10 10 8 10 8 8 10 10 10 8 10 8 10 10 8
8 10 8 8 10 10 8 10 8 8 8 10 8 10 10 8 8 10 8
8 8 10 10 8 10 8 10 8 8 10 10 10 8 10 8 10 8 10
9 9 9 9 9 9 9 9 9 9 9 9 9 9 9 9 9 9 9
12 12 12 12 12 12 12 12 12 12 12 12 12 12 12 12 12 12 12
