19 12
13 13 13 13 13 14 14 13 13 13 13 13 13 14 14 14 13 13 13
13 13 14 14 14 13 13 13 14 14 14 14 14 13 13 13 14 14 14 
13 14 14 14 13 13 14 14 14 14 14 14 14 14 14 14 14 14 14 
14 14 15 0 13 14 14 15 15 15 15 15 14 14 14 0 0 0 0
14 15 15 0 14 0 0 0 15 15 0 0 0 0 0 15 15 0 0
0 0 0 0 0 0 0 15 15 0 0 0 0 15 15 15 0 0 0 
0 1 1 1 0 15 15 1 1 1 1 1 0 0 15 1 1 1 0
1 1 0 0 15 15 15 0 0 0 15 15 0 0 0 15 15 0 0
13 0 0 0 15 15 15 0 0 0 0 15 15 0 0 0 15 15 0
13 13 0 15 15 15 0 13 13 0 15 15 0 13 13 0 15 15 15
13 13 13 13 13 13 13 13 13 13 13 13 13 13 13 13 13 13 13 
13 13 13 13 13 13 13 13 13 13 13 13 13 13 13 13 13 13 13 